0x00 0x2100  
0x01 0x01E1  
0x02 0x0180  
0x03 0xDD01  
0x04 0x0000  
0x05 0x0000  
0x06 0x0000  
0x07 0x0000 
0x08 0x0000 
0x09 0x0000 
0x0a 0x0000 
0x0b 0x0000 
0x0c 0x0000 
0x0d 0x0000 
0x0e 0x0000 
0x0f 0x0080 
0x10 0x0079 
0x11 0x6000 
0x12 0x5C05 
0x13 0x3245 
0x14 0x0000 
0x15 0x8000 
0x16 0x8000 
0x17 0x0000 
0x18 0x0200 
0x19 0x0000 
0x1a 0x0000 
0x1b 0x0020 
0x1c 0x0001 
0x1d 0x0000 
0x1e 0x0000 
0x1f 0x2100  


